#########################################
#S# # # # #     # # #       #   # # #   #
# # # # # ##### # # ### # # # ### # ### #
#       #         #     # # #     # #   #
####### ##### ### # ############# # ### #
#     # # #   # #   # # #             # #
### # # # # ### ### # # # ############# #
#   # #     #   #     #   #   #   # # # #
# ######### ### ### ### # ### ### # # # #
#         # #   # #   # #     #       # #
### ### # # # # # ### # ##### # # ##### #
# # # # #     # #       #     # #       #
# ### # # # ### ##### ##### ##### ##### #
# #   # # # # # #   # #   # # # #     # #
# ### ####### # # ####### # # # # #######
# # # # # #     #     #   #   #     #   #
# # # # # # ######### # ### ### ##### ###
#       # # #   #     # # #             #
# # ### # # # ##### ### # ### # # # # # #
# # #   # # #   # #     #     # # # # # #
# ### ### # # # # # ### # # ### ### #####
# #           #   # #   # # #     # #   #
######### ### ### ### # ##### ##### # # #
#     #     # #   #   # # #     #   # # #
### ### # ##### ### # ### ##### ### # ###
# # # # # # # #     #   #   #     # # # #
# # # ### # # ### ##### # ####### # # # #
#   #       #   # #       #   # # #     #
### # ### ##### ##### ##### ### # # # # #
#     #   # # # #   # #     # # # # # # #
######### # # # # # # # # # # # #########
#     #   # #   # # #   # # # #     # # #
# ### # ### ### ### ### # # # ### ### # #
# #     # #   #     #   # #             #
####### # # ### ####### # # # # ##### ###
#   #         # #       # # # #   #     #
# # # # ### ### # ### ### # ##### # ### #
# #   #   # #       #   # # #   # # #   #
############### ### ####### # # # # #####
#               #   #       # #   #    E#
#########################################