#############################################################
#S      # #   #   #   # # #   # # #     #     # #     #     #
# ### # # # # ### ### # # ### # # # ######### # ##### ### ###
# # # # #   #   # # # #                   #         #       #
### ### # ##### # # # ### ### ####### ### ######### ### #####
#     # # #     #     #   #   #       #     # #       #   # #
##### # ### ##### ### # ### ### ########### # ##### ### # # #
#       #   # #   #     #   # #     #   # # #       #   #   #
# ### ### # # ##### # # # ### # # ##### # # # ##### # # # ###
# # #     #     # # # # # # # # #     #   # #   #     # #   #
### ### ######### ##### ### # ### ##### ### ### #############
# #   #     # # # # #   #     # # # #   # #   #   # # # #   #
# # ### ##### # # # # ##### ### # # # ### ### # ### # # # ###
#   #           # #     #       # #   #   #   #   #     #   #
### # ### ####### ##### # ######### # # ### ### # # # # ### #
# # # #             #       #     # #           #   # # # # #
# # ##### # ####### # ######### ######### ####### ##### # # #
# #       #     # # #   # #     #   #     #   #       # #   #
# ### # # # # ### # # ### ### ### # # ##### ### ### # # ### #
# # # # # # #     # #   # # # #   # #   #   #     # # #   # #
# # # ### # # ####### ### # # # ### ### # # # ##### # ### # #
#       # # #   # # #     # #   #     # # #   #     # #   # #
##### ######### # # # ### # # ##### # ### ############### # #
#     # #       # # # # #       #   # #       # #   # #     #
### ### # ####### # # # ### ### ### ########### ### # #######
#     # #   # # # # #   #     # #   # #             # # #   #
# ##### # # # # # # ######### # ### # # ##### ### ### # # ###
# # # #   # # # #       #     #   #   # #       #     #   # #
# # # # # ### # # ########### # ### ### # ########### # ### #
#     # #         #       #   # #       #         #         #
# # # ####### # # ### ### # ##### # # # ####### # # # ##### #
# # # #   #   # # #   #   # #   # # # #   #     # # #   #   #
######### # ##### # # # ### ### ######### # # ### # # ##### #
#   #       #   #   # #   # #   #   #     # #   # # # #     #
### ### # ### ####### ######### # ####### ########### # #####
# # #   #       #   # # #       #         #         # # #   #
# # # ##### # # ### ### ### # # ######### # ####### ##### # #
#     #     # #     #   #   # # #     # #   #     # # #   # #
######### ### ### ##### # ##### # ### # ##### ##### # # ### #
# # # # # # # # #     # # #   #   # #       # #     #   # # #
# # # # ### ### # ### # # # # # ### ##### ### ### # ### # ###
#           #   # #       # #   #   #   # #     # # #       #
# ### # ### # # ### # ### # # ### # # # ####### # ######### #
# # # #   # # # #   #   # # #   # #   #   #     #   #       #
### ### # ### ### ####### ### # ######### ### # ### ### ### #
# #     #       #   # #     # #         #   # #           # #
# ### ### # ######### # ####### ####### ### ##### # # # #####
#       # #       #     #   #   #   #     #   #   # # #   # #
### ####### ####### ##### ##### # ####### # # # # ##### # # #
#   #         #     #   #     # # # #     # # # #   # # #   #
# ### # # # ### ##### # ### ### # # ### ### # ####### # ### #
# #   # # # #   #     # #   #   #   #       #           #   #
####### ##### ### ### ##### # ### ##### #####################
# #   # #     #   #   # #   # #     # #   #           # #   #
# # ### ### ##### ##### ### # # ##### ##### ##### # # # # # #
#   #           #     # # # #     # # #     #     # # # # # #
# ##### ####### # ##### # # # ##### # ### ### ##### # # ### #
#       #         #           #     #     #     #   #       #
# ##### ##### # # # # # # # ### # # # ### ### # ### ##### # #
#   #   #     # # # # # # #     # #     #   # # #       # #E#
#############################################################