#############################################################
#S      #       #                   #           #           #
# ##### # # # # # # # # # # # ######### # ##### ####### # ###
# #       # # # # # # # # # # #       # # # #         # #   #
##### ######### ##### ############# # ##### # ### # ####### #
#   # #   #   # # #         #   # # #   # # # #   # # # #   #
### # # ##### ### # ####### # ### ### ### # # ####### # # ###
# #   # #   # # #   #   #     # # #   # #   # # #     #   # #
# # ### ### # # # ### ### ##### # ### # # # # # ##### ### # #
#   #       #         #                 # #       #         #
# # # # # # ### ### ### # # ### ######### # ### # # ####### #
# # # # # # #   #   #   # # # # #     # # # #   #     #   # #
### ##### # ######### # # # # # # ### # # ####### ### # ### #
# #   #   #   # #     # # # #     #   #   # # # # #   #   # #
# ### # # # ### # # # ##### # # # # # ### # # # # ####### # #
#     # # #       # # #   # # # # # #     #     # # #     # #
### ##### ############# # ### # # ######### ### # # ##### # #
#         # # #         #   # # # #     # #   # #   #       #
### ### ### # ### ### ####### ### # ##### ### ### ####### ###
#   #   #       #   #   # # # #   #       #   #   #   #     #
# ##### ### ### ### # # # # # ##### ####### # ### # # #######
#     #   #   #     # #   #       #         # #   # #     # #
##### ##### # ######### # ################### # ### # ##### #
#   #   # # #   # #     # #   #       #   #   # #   # #   # #
### ### # ### ### # ##### # # # # ##### # # ### # ### ### # #
# #     #   #   #   #   # # # # #   # # #     #   # #       #
# ### ##### ##### ### ### ### # # ### # # ######### # #######
#   #       # #   # # #   #     # # #   # #           #     #
### ####### # # ### # ### ### ### # # ##### ####### ##### ###
#       #   #   #           # #     #     #   #     #       #
### ##### ### ##### ####### ##### ### ####### # ######### # #
# #   # # #       #   #     # # # # # #       #   #     # # #
# ### # # # ### ##### ### ### # # # # ##### # ### ##### # # #
#   #       #   #     #     #       #     # # # # #   #   # #
# # ### ##### # ### ##### ##### # ### ### # ### # # # ##### #
# # #   # #   # # # #   #       # #   # # # # # #   #   #   #
# # # ### ####### # # ##### ####### # # ### # # ### ### # ###
# #   #   # #   # #   # # # #   #   # #   # #   #   # #     #
### ### ### # ### ### # # # # # # ##### ##### ### ### # #####
# #   #         # #   # # # # #     #         #   #   # #   #
# # ### ######### # ### # ### # ############# ### # # # # # #
# # #     #             # #   #   #   #         #   # # # # #
# # ##### ### ### ### ### ####### # ####### ####### # ### ###
#   #           # #     #   #     #       # #       #       #
##### ######### ######### # # ####### # # # # # # ### ##### #
# # #     #     #       # #           # #   # # # # # #     #
# # # ##### ####### ############# # ##### ### ### # ### # ###
#     #   #       #   #   # #     #     # #     #   #   # # #
##### ### # # ### # ### ### ######### # ##### ####### ##### #
#   # #   # # # # # # # #   #     #   #       # #   #   # # #
# ##### ####### # # # # ### ##### # ### # ##### # ### ### # #
#         #       #     #             # #   #       # #     #
####### ### ####### # ### ### # ####### ##### # ### # ### ###
#   # #     #       # # #   # # #   # #   #   # # #       # #
### # # ########### ### ####### ### # ########### # ##### # #
# #             #   # # # #         # # # #       # #   # # #
# ### ####### # # # # # # ######### # # # # ### ##### ##### #
#   #   #   # #   #     #       #   #     # #               #
### # ### # # # # ### # ### # # # # # # # # # ### # ### # ###
#       # #   # #   # # #   # #   #   # #   #   # # #   #  E#
#############################################################